B.##......
#.##..###.
#.###.###.
#.....###.
###.#####P
