S.##......
#.##..###.
#.###S###.
#.....###.
###.######

